11111111111111111111111111111111
10000010010010011100100100000101
10100000001101001000000010000001
10000111000000000000000000001011
10100010000100100011000000000001
1001000100000000C001101000000111
10000100001000000010100001000001
10010001000110000100001001100011
10000000100000011001100000001001
100000000P0000000010001001000011
10100110000000000110010000000001
10000000110000001101000001001011
11011010010010000100100010001001
10001111000010000110010001010001
10010101010110011010110000000101
10000100011100000010000000010001
10010000001000001010011000010011
10100000000000010100000000001011
10000000100010000011100000110001
10001101000001000E00001000010011
10101000101000000000010010011001
10001000100000001000000000000001
10100100000000000010101000110001
11111111111111111111111111111111