111111111111111111111111111111111111111111111111111111111111111111111111111111111
100000000000E00000000000000000000000000000000000000000000000000000000000000000001
100000000000C00000000000000000000000000000000000000000000000000000000000000000001
100000000000C000000000000CCCCCCCCCCCCCC000000000000000000000000000000000000000001
100000000000CCCCCCCCCCCCCCCCCCCCCCCCCCCCCCCC0000000000000000000000000000000000001
1000000000000000000000000000E000000CCCCCCCCC0000000000000000000000000000000000001
1000000000000000000000000000000CCCCCCCCC00000000000000000000000000000000000000001
100000000000000000000000000000000000000000000000000000000000000000000000000000001
100000000000000000000000000000000000000000000000000000000000000000000000000000001
10000000000000000000000000000CCCCCCCCCC000000000000000000000000000000000000000001
100000000000000000000000000000CCC000000000000000000000000000000000000000000000001
1000000000000000000000000000000CCC00000000000000000000000000000000000000000000001
100000000000000000000000000000000C00000000000000000000000000000000000000000000001
1000000000000000000000000000000000C0000000000000000000000000000000000000000000001
1000000000000000000000000000000000C0000000000000000000000000000000000000000000001
1000000000000000000000000000000000C0000000000000000000000000000000000000000000001
1000000000000000000000000000000000C0000000000000000000000000000000000000000000001
1000000000000000000000000000000000C0000000000000000000000000000000000000000000001
1000000000000000000000000000000000C0000000000000000000000000000000000000000000001
1000000000000000000000000000000000C0000000000000000000000000000000000000000000001
1000000000000000000000000CCCCCCCCCCCCCCCCCCC1000000000000000000000000000000000001
1000000000000000000000CCCCCCCCCCCCCCCCCCCCCC1000000000000000000000000000000000001
10000000000000CCCCCCCCCCCCCCCCCCCCCCCCCCCCCC1111111111111111111111111111111111111
10000000000000000000E0000000000000000000E0000000000000000000000000000000000000001
100000000000000000000000000000000000000000000000000000000000000000000000000000001
100000000000000000000000000000000000000000000000000000000000000000000000000000001
100000000000000000000000000000000000000000000000000000000000000000000000000000001
100000000000000000000000000000000000000000000000000000000000000000000000000000001
100000000000000000000000000000000000000000000000000000000000000000000000000000001
100000000000000000000000000000000000000000000000000000000000000000000000000000001
100000000000000000000000000000000000000000000000000000000000000000000000000000001
100000000000000000000000000000000000000000000000000000000000000000000000000000001
100000000000000000000CCCCCCCCCCCCCCCCC0000000000000000000000000000000000000000001
1000000000000000000000000000CCCCCCCCCCCCCCCC0000000000000000000000000000000000001
10000000000000000000000000000CCCCCCCCCCC0000000000000000000000000000CCCCCC0000001
1000000000000000000000000000000CCCCCCCCCC00000000000000000000000CCCCCCC0000000001
100000000000000000000000000000000CCCCCC0000000000000000000000000000CCCCCCCC000001
10000000000000000000000000000000000CCCCCC000000000000000000000CCCCCCCC00000000001
10000000000000000000000000000000000000CCCCC0000000000CCCCCCCCCCCCCCCCCCCCC0000001
1000000000000000000000000000000000000000000000000000000000000000000CCCCC000000001
100000000000000000000000000000000000000000000000000000CCCCCCC00000CCCCCCCCC000001
100000000000000000000000000000000000000000000000000000000000000000000000000000001
100000000000000000000000000000000000000000000000000000000000000000000000000000001
1000000000000000000000000000000CCCCCCCCCCCCCCCCCCCCCCCCCCCCCCCCCCCCCCCCCCCC000001
100000000000000000000000000000000000000000000000000000000000000000000000000000001
100000000000000000000000000000000000000000000000000000000000000000000000000000001
100000000000000000000000000000000000000000000000000000000000000000000000000000001
100000000000000000000000000000000000000000000000000000000000000000000000000000001
100000000000000000000000000000000000000000000000000000000000000000000000000000001
10000000000000000000000000000000000000000P000000000000000000000000000000000000001
111111111111111111111111111111111111111111111111111111111111111111111111111111111
