1111111111111111111111111111
1000000000000P00000000000001
1011111111111111111111111001
1010000000000000000000001001
1010C000000CCCCC00C000001001
1010C000000C000C00C000001001
1000C000000C000C00C000000001
1000C000000C000C00C000000001
1010C000000C000C00C000001001
1010CCCCC00CCCCC00CCCCC01001
1010000000000000000000001001
1011111111111111111111111001
1000000000000EE0000000000001
1111111111111111111111111111
