1111111111111111111111111111111111111111111111111111111111111111111111
1C11011010001000100010010100000000100101100000000111100000000000111101
1011000C00010000000100001001000100010000010001001010000010100000000001
1000000000000011000000000000000010000000100000000110100001000110001001
100000001C000001100101100000000100111010110000000010001000001010100001
1000001000CC1000100000110000010010001000011000001001010010001110000001
1000010000000C10000001001100000110000000010101000000000101100101100001
11010000100000CC001010001010000000010000100000010001000000000001001001
1000010000000010011000101011100010000000100100000000010010100001110001
1001000000001011000100000100001000010001010000000011100000001010000001
1010010000010100001100010100100100100100011100001000010100000000000001
1010000000000010000001001000010110100000000100010011001010010001110111
10100000100010100C0000100011000000100001000100101100100000000100000101
1001101100010001000000001000111000000001100001000001000000000000000011
1000000010000001110C10000100000000000101010000000000000001001100000001
11000000110101000010100000C1101000010100000000000001000100000010000001
1000001100010001010100010000100000000010010000011001010111100000100001
1000001110011000110000001001100000000000100000011000010000000100000101
1010000000000000100111000001110000100000000010100000000100110000000111
1001101010010101000110000010C10000001001000100011011000011100000000001
10001001001001010000100000001010C10C1000001001000000000001001000010001
100100100000010111100000000100000000C000010100101111000110010000011001
100001000000001010011000000011001010C000110010000100011000101010011001
1000000001000000001000001010000000000011101110010010000100100100010111
10000111001000110001100001101010000P00001101C0000001011010011000111001
100010000010001000110011100000000000000000100C00000100C010100000110111
1000000100011000010000001010000011000000110000001010100000000000000011
1001001000010000000000000001100000000000110010100100000100000110100001
10101001000110010010000000010001000110001011001100100010C0101000000111
11001000000001000000000001000000001101100000100101000001010C0000000011
1000000101000000101010010010011001010000000000110000010001100000001011
100010000100010001001000000001000100001001000100000101000001C000100101
101000010000111111000100001101001001000100011010000100011010001C000001
1010011100010000100001100100000000000001011001000000000100001001000011
1011000010000000000001011001000011000010000000010100000010000000100011
10000010000000001E0100000000110000011001000001000011010000000011110111
1100100001000010000100100000000000010000010001101100001001000000C00101
1000100100000100000000010000000100000111010000000000000000000000000001
10011000000001010100000000100010001010001001001000100001000010000100C1
1111111111111111111111111111111111111111111111111111111111111111111111