111111111111111111111111111111111111111111111111111111111111111111111111111
10C000100111000000010011110001000000001000001000001000001001010100101011001
11CC00001001001000011011000101000100001011010000000011010100011000111000011
101C10000100101000001001010001000011000000000000000000000000001000010100101
1100CC011110000000100110000000010000100000001100101010101110010100010010111
10110C011000000100001000001100000000001010010101011001000101010000100011011
10000011110C110001010010000100000010110010000001000100000000100110000011001
110011010000000000100000101000101110001100001010000110000010110111001100011
10000001101C100010000000001100000011100000000011000000011001000000000001011
110000110001011000100000000111000101000000000001000010010110000010000100011
100101000101100101010001000101000000000000000100000100001000001000001000001
110010100001C0010001000110C000001011001000001000001101000000010110000000011
100001000C00C00110110100101001000000000000000011100001000000100110000010001
100000001000010100000100000000000010001000000000011010110001001100000010101
1100001111000C00CC010000010011110000000011110100001001001110100000100001001
111100000100000100CC1100000100000111001110000110101001001100001000000000001
10100001001000100000C001101000000100110010011001010010001100100011000100101
1010110000000C1100011000000100000000110100000000001001011110000010010100001
100000001010000000000100100001001000010000000001000000000110110000110001001
100000000010000000110C00010010000100000000010010001010100000100000000001111
1C00000000010101000000C0011000110001010011000010011000000000001001000010001
10000100000101001100000000010C0C0000011000110010100000000000000010001000001
100000100100010001100000000010000C01101010001110101010110000110110000100101
100100000001100010010010001000000CCCC00000000000000010000000010001111000001
101000000000000000010000010010010001101100100010000010000000000000010000001
11000101000001000000000001100000100100C001000000000001100101000001100100001
10011000001010001010000000000110011101C000000100110001100001010000010010001
10000011110000000001000000000010100010000CC100110000C0010100111000100000001
1100000001001000000110010110010001010100001000010000C0000010101001000000101
101010100000100010110000000000010010001010011000000000100001000000100100001
100000110000010001110100000000000000000000000000000000111000010000010001001
1000000000001010000000110110101000010110010100000010C0100001101010000000001
11000001000000000001100000011010001000010000000000110C100C11101000110100001
1010000001000000000110001010110000000000000000P0000000010C01000000100000001
10100001000010101000110110000000000001001000000010000000010C100100000100001
11001000100000000000101010010000110000001010110100001001000CC11000000110001
101000011110000110100000111011101000001000100111010010010001C01100000110001
11000000001001000000000000101100000010010000000110000011100000C001010001011
101100100000000001000100000101101000100100001010011000000000000010C00011001
10000100E100000010101000000001000100000100000100010001100000100000001010C11
1010110011010000000011000000000000011000010100000110100000101000000001010C1
111111111111111111111111111111111111111111111111111111111111111111111111111