111111111111
1CC0C0C00001
1CCCC1P00001
1CC1CCC10011
1C0001CC0011
10C00CCCC001
1100CCC0CE11
111111111111